#                                              #####
#                                ###           #####
#                                          #########
#  ###                     ###                 #####
#                                  ###         #####
#                                         ###  #####
######                                         #####
######     ###  ###   ###        ###     ###   #####
#######                                       ######
########                              ###      #####
####################################################
####################################################
####################################################
####################################################