xxxxxxxxxxxxxxxx
x..............x
x..xxxx...x....x
x.........x....x
x.....x...x....x
x.....x...x....x
x.....x........x
x.....x........x
x.....x...xx...x
x.....x........x
x..............x
x...xxxxxxxx...x
x......x.......x
x..x...x....x..x
x..x........x..x
xxxxxxxxxxxxxxxx
