xxxxxxxxxxxxxxxxxxxx
x...xxxx........x..x
x...........x...x..x
x......x....x......x
x......x.......x...x
x..x...x.......x...x
x..x.......x...x...x
x..x.....x.....x...x
x..x.....x.....x...x
x..x...xxx.........x
x........x.........x
x........x...x.....x
x...xxx..x...x...xxx
x........x...x.....x
x........x.........x
x.xxx....x.....xxxxx
x..................x
x...xxxxxxxxxxx....x
x..................x
xxxxxxxxxxxxxxxxxxxx