                                                   .
                                                   .
                         /\                        .
          /\            /--\          /\          /.
         /--\        /\/----\  /\    /--\    /\  /-.
  /\    /----\  /\  /--------\/--\  /----\  /--\/--.
 /--\  /------\/--\/--------------\/------\/-------.
/----\/--------------------------------------------.
---------------------------------------------------.
---------------------------------------------------.
---------------------------------------------------.
---------------------------------------------------.
---------------------------------------------------.
....................................................